program	    CONTROL     0
var	        VAR	        0
array	    ARRAY	    0
of	        ARRAY	    1
integer	    TYPE	    0
real	    TYPE	    1
function    FUNCTION	0
procedure	CONTROL 	1
begin	    CONTROL	    2
end	        CONTROL	    3
if	        CONTROL     4
then	    CONTROL	    5
else	    CONTROL	    6
while	    CONTROL	    7
do	        DO	        0
div	        MULOP	    0
mod	        MULOP	    1
and	        MULOP	    2
not	        NOT	        0
or	        ADDOP	    0

